1,1,1,1,1,1,1,1,1,1,1,1,1,1,1,1,1,1,1,1
1,1,2,2,2,1,1,1,1,2,2,2,2,2,2,2,2,2,3,1
1,1,2,2,2,5,5,5,5,2,2,2,2,2,2,2,2,2,2,1
1,1,2,2,2,1,1,1,1,2,2,2,2,2,2,7,2,2,2,1
1,1,1,6,1,1,1,1,1,2,2,1,6,1,2,7,7,7,7,1
1,1,1,6,1,1,1,1,1,2,2,6,2,1,2,2,2,2,2,1
1,1,1,6,1,1,1,1,1,2,2,1,6,1,2,2,2,2,2,1
1,1,1,6,1,1,1,1,1,2,2,2,2,2,2,2,2,2,2,1
1,1,1,6,1,1,1,1,1,2,2,2,2,2,2,7,7,2,2,1
1,1,1,6,1,1,1,1,1,7,7,7,2,2,2,7,7,2,2,1
1,2,2,2,2,2,2,2,2,7,7,7,2,2,2,2,2,2,2,1
1,2,2,2,2,2,2,2,2,7,7,7,2,2,2,2,2,2,2,1
1,2,2,2,2,2,2,2,2,7,7,7,2,2,2,2,2,2,2,1
1,2,2,2,2,2,2,2,2,7,7,7,2,4,4,4,4,4,1,1
1,2,2,2,2,2,2,2,2,7,7,7,2,4,4,4,4,4,1,1
1,2,2,2,2,2,2,2,2,2,2,2,2,4,4,4,4,4,1,1
1,2,2,2,2,2,2,2,2,2,2,2,2,4,4,4,4,4,1,1
1,2,2,2,2,2,2,2,2,2,2,2,2,4,4,4,4,4,1,1
1,2,2,2,2,2,2,2,2,2,2,2,2,1,1,1,1,1,1,1
1,1,1,1,1,1,1,1,1,1,1,1,1,1,1,1,1,1,1,1